4 0 -4 0 0 -3 0 3 0 0 
4 0 -4 0 0 -3 0 3 -2 5 2 5 -2 -4 2 -4
-5 0 5 0 -2 -4 -2 4 -1 2 -1 -2 1 2 1 -2 2 4 2 -4
4 0 -4 0 0 -3 0 3 -2 5 2 5 -2 -4 2 -4 6 4 -6 4 -6 -4 6 -4
-4 -3 -4 0 -4 3 -2 -3 -2 3 0 -3 0 3 2 -5 2 5 4 -5 4 0 4 5 2 2 2 -2
-5 -3 -6 4 -3 0 0 -2 0 -5 1 2 2 5 4 -3 5 0
5 0 -5 0 -4 4 -2 -1 -2 -4 0 2 0 -2 1 -4 1 0 3 0 3 3
-6 -5 -6 5 -4 4 -3 -2 -2 -4 -2 6 -1 2 1 -1 1 5 2 -3 3 1 4 -5 5 -3 -6 0